Lista de Amigo secreto 2017 

Alfonso Villalobos => Luis Sura
Luis Sura => Jorge Villabos
Jorge Villabos => Gloria e Ivan
Gloria e Ivan => Camilo Fernandez
Camilo Fernandez => Constanza Vilches
Constanza Vilches => Elias Vilches
Elias Vilches => Viviana Garrido
Viviana Garrido => Antonia Ortega
Antonia Ortega => Daniel Abarca
Daniel Abarca => Claudia y Nano
Claudia y Nano => Maria Isabel Abarca
Maria Isabel Abarca => Paola y Andres
Paola y Andres => Ivan Fernandez Abarca
Ivan Fernandez Abarca => Nicolas Vilches
Nicolas Vilches => Irma Lagos
Irma Lagos => Marjorie y Roberto
Marjorie y Roberto => Araceli y Juan
Araceli y Juan => Marianela y Luis
Marianela y Luis => Agustin
Agustin => Monica y Bastian
Monica y Bastian => Jessica y Andres
Jessica y Andres => Manuel Garrido
Manuel Garrido => Vicents Vilches
Vicents Vilches => Karen Garrido
Karen Garrido => Miguel Abarca Medina
Miguel Abarca Medina => Carmen Garrido
Carmen Garrido => Patricio Mu単oz
Patricio Mu単oz => Juan Pablo Sura
Juan Pablo Sura => Patricia y Luis
Patricia y Luis => Maximo Vilches
Maximo Vilches => Juan Ignacio
Juan Ignacio => Susy y Emilio
Susy y Emilio => Yessenia Mu単oz
Yessenia Mu単oz => Trini
Trini => Luis Ignacio
Luis Ignacio => Catalina Ortega
Catalina Ortega => Stefy Villalobos
Stefy Villalobos => Tatiana Fernandez
Tatiana Fernandez => Emilia Sura
Emilia Sura => Marisol y Nano
Marisol y Nano => Maria Garrido
Maria Garrido => Alfonso Villalobos
